
0,0,0,0,0,0,0,0,0,0
6,1,1,7,0,0,6,1,1,1,1,1,7
2,5,5,3,0,0,2,5,5,5,5,5,3
2,5,5,3,0,0,2,5,5,3,4,4,4
4,4,4,4,0,0,4,4,4,4
0,0,0,0,0,0,0,0,0,0,0,0,6,1,1,7
6,1,1,7,0,0,6,1,1,7,0,0,2,5,5,3
2,5,5,3,0,0,2,5,5,3,0,0,2,5,5,3
2,5,5,3,0,0,2,5,5,3,0,0,4,4,4,4
4,4,4,4,0,0,4,4,4,4
0,0,0,0,0,0,0,0,0,0
6,1,1,7,0,0,6,1,1,7
2,5,5,3,0,0,2,5,5,3
2,5,5,3,0,0,2,5,5,3
4,4,4,4,0,0,4,4,4,4
0,0,0,0,0,0,0,0,0,0
6,1,1,7,0,0,6,1,1,7
2,5,5,3,0,0,2,5,5,3
2,5,5,3,0,0,2,5,5,3
4,4,4,4,0,0,4,4,4,4